NO ./path_to_the_north_texture
F 220,100,0
SO ./path_to_the_south_texture
WE ./path_to_the_west_texture
C 225,30,0
EA ./path_to_the_east_texture







        1111111111111111111111111        1
        1001110000110000000000001
        1011100001111111111111111     1     1     1
        10010000000001
1111111110110000011101111111111111
1000000000110000011111111111111111111111
111111111111110111000000111
        11 111111111111111
        
11111111111111111111111111111
11000011110101   111000000111
1000001 100001111110000001001
100000111000000011011100100011
11000001110101011111 11110N0111
11110111 1110101 101111010001
11111111 1111111 111111111111

 
  
   
    
     
         
           
            
             
                 
                  
                 