NO ./path_to_the_north_texture
SO ./path_to_the_south_texture
WE ./path_to_the_west_texture
EA ./path_to_the_east_texture
F 220,100,0
C 225,30,0

        1111111111111111111111111        1
        1001110000110000000000001
        1011100001110011111111111     1     1      1
        10010000000001
1111111110110000011101111111111111
100000000011000001111111111111111111111
111111111111110111000000111
              1   111111
                   
        
11111111111111111111111111111
11000001110101   11100000011111
1000001 1000001111100000010001
100000010000000011011100100011
11000001110101011111 11110N0111
11110111 1110101 101111010001
11111111 1111111 111111111111