NO xpm/n.xpm
SO xpm/s.xpm
WE xpm/w.xpm
EA xpm/e.xpm
F 102,102,102
C 38,181,255
1111111111
1000000001
1000100001
1000100001
1000000001
1N00000001
1111111111