              NO           xpm/blue_wall.xpm



          F                      255,0,0


SO  xpm/red_wall.xpm



WE xpm/green_wall.xpm           



EA                               xpm/yellow_wall.xpm


C 225,0,0



        1111111111111111111111111        1
        1111 11111111111111111111
        1001110000110000000000001
        1011100001111111111111111     1     1     1
        1001000000000111111111
1111111110110000011101111111111111
1000000000110000011111111111111111111111
111111111111110111000000111
        11 111111111111111
     
          
               
11111111111111111111111111111
11000011110101   111000000111
1000001 100001111110000001001
100000111000000011011100100011
11000001110101011111 11110N0111
11110111 1110101 101111010001
11111111 1111111 111111111111